111111111111111
1000000E0000001
1000P0000000001
100000000000001
100000000000001
100000000000001
100000000000001
100000000000C01
100000000000001
100000000000001
100000000000001
100000000000001
100000000000001
100000000000001
111111111111111
