111111111111111
1000000E0000001
1000P0000000001
100000000000001
100000000000001
100001110000001
100011CC0000001
100011110000001
100001110000001
100001010000001
100000000000001
100000000000001
100000000000001
100000000000001
111111111111111
